......@@..##..##..##......
......@@..##..##..##......
..##..##..........@@......
..##..##..........@@......
..##..##....@@....@@..@@..
..##..##....@@....@@..@@..
..##......##..@@##......@@
..##......##..@@##......@@
........####..####..@@....
........####..####..@@....
....@@..##....####..####..
....@@..##....####..####..
@@..@@....##..@@....@@##..
@@..@@....##..@@....@@##..
....####..##......##@@....
....####..##......##@@....
..@@####..####..####....##
..@@####..####..####....##
..##......##@@........####
..##......##@@........####
......##..####@@..@@....##
......##..####@@..@@....##
##..####..........##@@....
##..####...####...##@@....
##..##.....#..#...######..
##..##.....#..#...######..